{
  "1": [
    {
      "id": 1,
      "name": "Full",
      "art": [
        "+-------------------------+",
        "|                         |",
        "|                         |",
        "|            A            |",
        "|                         |",
        "|                         |",
        "+-------------------------+"
      ]
    }
  ],
  "2": [
    {
      "id": 1,
      "name": "Side by side",
      "art": [
        "+------------+------------+",
        "|            |            |",
        "|      A     |      B     |",
        "|            |            |",
        "|            |            |",
        "|            |            |",
        "+------------+------------+"
      ]
    },
    {
      "id": 2,
      "name": "Stacked",
      "art": [
        "+-------------------------+",
        "|                         |",
        "|            A            |",
        "+-------------------------+",
        "|                         |",
        "|            B            |",
        "+-------------------------+"
      ]
    }
  ],
  "3": [
    {
      "id": 1,
      "name": "Equal Thirds",
      "art": [
        "+--------+-------+--------+",
        "|        |       |        |",
        "|   A    |   B   |   C    |",
        "|        |       |        |",
        "|        |       |        |",
        "|        |       |        |",
        "+--------+-------+--------+"
      ]
    },
    {
      "id": 2,
      "name": "Side + Stacked",
      "art": [
        "+------------+------------+",
        "|            |     B      |",
        "|     A      |            |",
        "|            +------------+",
        "|            |     C      |",
        "|            |            |",
        "+------------+------------+"
      ]
    },
    {
      "id": 3,
      "name": "Stacked + Side",
      "art": [
        "+------------+------------+",
        "|     B      |            |",
        "|            |     A      |",
        "+------------+            |",
        "|     C      |            |",
        "|            |            |",
        "+------------+------------+"
      ]
    }
  ],
  "4": [
    {
      "id": 1,
      "name": "2×2 Grid",
      "art": [
        "+------------+------------+",
        "|      A     |      B     |",
        "|            |            |",
        "+------------+------------+",
        "|      C     |      D     |",
        "|            |            |",
        "+------------+------------+"
      ]
    }
  ]
}
